       ##     ##
     ##  ## ##  ##
   ##      #      ##
 ##                 ##
##   . ##    ##  .  ##
##   .     o     .   ##
##   . ##    ##  .  ##
 ##                 ##
   ##      #      ##
     ##  ## ##  ##
       ##     ##