######
#o.. #
#.##.#
#....#
###### 