		   #####################
		   #o .   .#   #   #   #
		   ### ###.### # # # # #
		   #   . # .   #   # # #
		   # ###.#.####### # # #
		   # #   #.#   # # # # #
		   # ###.#.# ### # # ###
		   # # . #...# # # #   #
		   # ###.###.# # # ### #
		   #   . #   # # # .   #
		   ### #######.# # #####
		   # . #   #   #   #   #
		   # # # # # ### ### # #
		   # # # # # .   #   # #
		   # # ##### # ### # # #
		   # #     # #   # . # #
		   # ##### # ##### ### #
		   #     # #   #  .    #
		   # ### # ##### # #####
		   #   # # # . # #     #
		   ### # # # # # #######
		   #   # # # #   #     #
		   # ### # # ### # # ###
		   # #   # # #   # #   #
		   # # ### # # ### ### #
		   #     #   . # .   # #
		   #####################