                                                   
        ########          #########                
      ####.....###      ###.......##               
     ##..........###   ##..........##              
    ##.............## ##............#              
   ##...............###.............#              
   ##..............................##              
    ##....................o........##              
    ##............................##               
     ##..........................##                
       ##.......................##                 
        ##.....................##                  
         ###..................##                   
           ##................##                    
             ##............##                      
              ##..........##                       
               ##........##                        
                ###.....##                         
                 ###..##                           
                   ####                            
                    ##                             
                                       