########
#o...#.#
#.#.#..#
#.#.####
#...#..#
#.##...#
#...####
########